$
$
$
$
$$$$$$$$$$$$$$(###)
$$$$$$$$$$$$$$(...)
$$$$$$$$$$$$$$(...)
$$$$$$$$$$$$$$(...)
$$$$$$$$$$$$$$(...)
$$$$$$$$$$$$$$+...-$$$$$$$$$$$$$$$$$$+###-$$$$
$$$$$$$$$$(####...####-$$$$$$$$$$+####...####)
$$$$$$$$$$(...........############...........)
$$$$$$$$$$(..................................)
$$$$$$$$$$(..................................)
$$$$$$$$$$(.....@......................@.....)
$$$$$$$$$$(...........%^^^^^^^^^^*...........)
$$$$$$$$$$$^^^^^^^^^^^$$$$$$$$$$$$^^^^^^^^^^^$
$